###########################
#      ##    .    ##      #
#.#### ## ####### ## ####.#
# #### ## ####### ## #### #
#      .     .     .      #
### ## ##### # ##### ## ###
  # ##.#   # # #   #.## #  
### ## ##### # ##### ## ###
  # ##       #       ##   #
### ##### ####### ##### ###
  # ##### ####### ##### #  
  #   .      ooo>  .     
  # ##### ###o## ##### #  
  # ##### #  o # ##### #  
  # ##    #  o #    ## #  
  # ## ## #    # ## ## #  
############# #############
       ##    .    ##       
### ######## # ######## ###
  # ######## # ######## #  
  #     .   #      .    #  
  # ##### ####### ##### #  
### ##### ####### ##### ###
