###################
#  .   .   .   .  #
# ##### # # ##### #
# . .   # #   . . #
# ### ### ### ### #
# # #  .   .  # # #
# ### ####### ### #
# . .         . . #
### #####.##### ###
#                 #
# ####### ####### #
#  .    # #   .   #
# ##### # # ##### #
#     #  .  #     #
#.# #.#.# #.#.# #.#
# # #   # #   # # #
#.# ##### ##### #.#
#ooo>             #
###################